{
    "h": "h",
    "e": "e",
    "l": "l",
    "o": "o",
    "w": "w",
    "r": "r",
    "d": "d"
}